NO     ./textures/bluestone.png
SO 			./textures/purplestone.png
WE 		./textures/wall_3.png
EA ./textures/pillar.png

F 220,100,0
C 225,30,0

111111111111111111111111111111
100000000011000000000000111111111
101100000111000000000000111111111
100100000000000000000000111111111
111111111011000001110000000000001
100000000011000001110111111111111
111101111111110111000000100011111
111101111111110111010111100011111
11000000110101011100011100011111
100000000000000011000111100011111
100000000000000011010100100011111
11000001110101011111011110N01
11110111111101011011110100011111
11111111 11111111111111111111111
